################
#TT............Q
#  ............Q
#..............Q
#..............#
#..............#
#..............#
#..............#
#...##.........#
#..............#
#..............#
#...####.......#
#..............#
#..............T
#@.............T
################