################
#TT............x
###............x
#  ............x
#..............T
#..............#
#..............#
#..............#
#...##.........#
#..............#
#..............#
#...####.......#
#..............#
#..............T
#@###..........T
################