################
x..............#
x..............#
x..............#
#...###........#
#..............#
#..............#
x..............#
#......TT......#
#......TT......#
#..............x
#..............x
#..............x
#..............#
#..............#
################