################
x.TT...........#
x..............#
X..............#
#...###........#
#..............#
#..............#
x..............#
#......  ......#
#......  ......#
#..............Q
#...TT....TT...Q
#...TTTTTTTT...Q
#...TT....TT...#
#..............#
################