################
x.TT...........#
x..............#
x..............#
#...###........#
#..............#
#..............#
x..............#
#......  ......#
#......  ......#
x..............x
x...TT....TT...x
x...TTTTTTTT...x
#...TT....TT...#
#..............#
################