################
x.TT...........#
x..............#
X..............#
#...###........#
#..............#
#..............#
x..............#
#......TT......#
#......TT......#
#..............Q
#..............Q
#..............Q
#..............#
#..............#
################