################
x.TT@..........#
x..............#
#..............#
#...###........#
#..............#
#..............#
x..............#
#......TT......#
#......TT......#
#..............#
#..............#
#..............#
#..............#
#..............#
################