################
x.TT...........#
x..............#
X..............#
#...###........#
#..............#
#..............#
x..............#
#......  ......#
#......  ......#
#..............Q
x...##....TT...Q
x...TT####TT...Q
x...TT....##...#
#..............#
#####QQQ########