################
#TT............x
#..............#
#..............#
#..............#
#..............#
#..............#
#..............#
#...##.........#
#..............#
#..............#
#...####.......#
#..............#
#..............#
#@.............#
################